IMA	= "countries/Idolmaster.txt"
ICG = "countries/Idolmaster Cinderella Girls.txt"
BDG	= "countries/Bang Dream.txt"
PRS	= "countries/Project Sekai.txt"
TOH = "countries/Touhou.txt"
ENS	= "countries/Ensemble Stars.txt"
LLS	= "countries/Love Live.txt"
UMA	= "countries/Umamusume.txt"
IML = "countries/Idolmaster Million Live.txt"
ISC	= "countries/Idolmaster Shiny Colors.txt"
ISM	= "countries/Idolmaster Side M.txt"
PRK	= "countries/Princess Connect.txt"
HBR	= "countries/Heaven Burns Red.txt"
STR	= "countries/Revue Starlight.txt"
ARG	= "countries/Argonavis.txt"
IDP = "countries/Idoly Pride.txt"
BLA = "countries/Blue Archive.txt"
TKI = "countries/Tokimeki Idol.txt"
WDS = "countries/World Dai Star.txt"
LAS = "countries/Last Origin.txt"
DFD = "countries/D4DJ.txt"
ONK = "countries/Oshi no Ko.txt"
TSS = "countries/Tokyo Seventh Sisters.txt"
DEN = "countries/Denonbu.txt"
AIN = "countries/Idolish Seven.txt"
FGO = "countries/Fate Grand Order.txt"
SBR = "countries/Show by Rock.txt"
AIK = "countries/Aikatsu.txt"
PRP = "countries/PriPara.txt"
GUP = "countries/Girls und Panzer.txt"
AZU = "countries/Azur Lane.txt"
GRB = "countries/Granblue.txt"
ZOS = "countries/Zombieland Saga.txt"
BOR = "countries/Bocchi the Rock.txt"
KON = "countries/KON.txt"

#NOTE: Useful to add a basic default loc entry for each tag in 00_countries.txt so that hovering over a tag will show the tag's name in loc (ie. PAP: "Papal States")
