#system
ZYX = "countries/ZYX_system_tag.txt"
#countries
IMA	= "countries/Idolmaster.txt" #아이마스
IDS = "countries/Idolmaster Dearly Stars.txt" #디어리마스
ICG = "countries/Idolmaster Cinderella Girls.txt" #데레마스
IML = "countries/Idolmaster Million Live.txt" #밀리마스
ISC	= "countries/Idolmaster Shiny Colors.txt" #샤니마스
ISM	= "countries/Idolmaster Side M.txt" #사엠마스
IGM = "countries/Idolmaster Gakuen.txt" #학원마스
TOH = "countries/Touhou.txt" #동방
PRS	= "countries/Project Sekai.txt" #프로세카
BDG	= "countries/Bang Dream.txt" #뱅드림
ENS	= "countries/Ensemble Stars.txt" #앙스타
LLS	= "countries/Love Live.txt" #럽라
LSS = "countries/Love Live Sunshine.txt" #럽라 선샤인
LNH = "countries/Love Live Nijigasaki.txt" #럽라 니지동
LST = "countries/Love Live Super Star.txt" #럽라 리엘라
LHH = "countries/Love Live Hasunosora.txt" #럽라 하스노소라
LBB	= "countries/Love Live Bluebird.txt" #럽라 블루버드
UMA	= "countries/Umamusume.txt" #우마무스메
PRK	= "countries/Princess Connect.txt" #프리코네
IDP = "countries/Idoly Pride.txt" #아돌프
HBR	= "countries/Heaven Burns Red.txt" #헤번레
STR	= "countries/Revue Starlight.txt" #가극레뷰
DFD = "countries/D4DJ.txt" #D4DJ
AGN = "countries/Argonavis.txt" #아르고나비스
BLA = "countries/Blue Archive.txt" #블아
TKI = "countries/Tokimeki Idol.txt" #토키메키 아이돌
WDS = "countries/World Dai Star.txt" #유메스테
TSS = "countries/Tokyo Seventh Sisters.txt" #나나시스
AIN = "countries/Idolish Seven.txt" #아이돌리시 세븐
SBR = "countries/Show by Rock.txt" #쇼바이락
DOB = "countries/Denonbu.txt" #전음부
GFR = "countries/GF.txt" #GF
KJI = "countries/Kokuhaku Jikko Iinkai.txt" #허니웍스 고백실행위원회
GUP = "countries/Girls und Panzer.txt" #걸판
LAS = "countries/Last Origin.txt" #라오진
ONK = "countries/Oshi no Ko.txt" #최애의 아이
FGO = "countries/Fate Grand Order.txt" #페그오
AZU = "countries/Azur Lane.txt" #벽람
ZOS = "countries/Zombie land Saga.txt" #좀랜사
BOR = "countries/Bocchi the Rock.txt" #봇치
KON = "countries/KON.txt" #케이온
SOE = "countries/Sound Euphorium.txt" #울려라 유포리엄
TAK = "countries/takt op.txt" #takt op
AIK = "countries/Aikatsu.txt" #아이카츠
PRP = "countries/PriPara.txt" #프리파라
SHP = "countries/Shinepost.txt" #샤인포스트
UNP = "countries/UtaPri.txt" #노래하는 왕자님
MMM = "countries/Madoka Magika.txt" #마마마
KTC = "countries/Kancolle.txt" #칸코레
MCR = "countries/Macross.txt" #마크로스
MLN = "countries/Magical Lyrical Nanoha.txt" #매지컬 리리컬 나노하
WUG = "countries/Wake Up Girls.txt" #Wake Up Girls
TSU = "countries/Tsukipro.txt" ###Tsukipro - 츠키프로
SZS = "countries/Senki Zessho Symphogear.txt" #전희절창 심포기어
IDC = "countries/Idol Chronicle.txt" #아이돌 크로니클
NPT = "countries/Hyperdimension Neptunia.txt" #초차원 게임 넵튠
GEC = "countries/Gecki Doll.txt" #게키돌
VCD = "countries/Vocadol.txt" #vocadol - 보카돌
HLL = "countries/Hololive.txt" #Hololive
DIF = "countries/Dropout Idol Fruit Tart.txt" #뒤떨어진 후르츠 타르트
LCD = "countries/Locodol.txt" #Locodol  #평범한 지역 아이돌
BPR = "countries/B Project.txt" ##B Project
POP = "countries/Pole Princess.txt" #Pole Princess - 폴 프린세스
CUE = "countries/CUE.txt" #CUE
UNU = "countries/Unite UP.txt" ##Unite Up
LVD = "countries/Love Doll.txt" #Love Doll
IDI = "countries/Idol Incident.txt" #아이돌 사변
AIC = "countries/Ai Chu.txt" ##아이츄
LPR = "countries/Lapis Relight.txt" #라피스 리라이츠
YMC = "countries/Yumeiro Cast.txt" ##꿈빛 캐스트
TAB = "countries/Tarot Boys.txt" ##Tarot Boys - 타로 남자
DRF = "countries/Dream Fes.txt" ##드림페스
AOP = "countries/Aopella.txt" ##아오페라
GBC = "countries/Girls Band Cry.txt" #걸즈 벤드 크라이
NNN = "countries/227.txt" #22/7
FBD = "countries/Favorite Idol Budokan.txt" #최애가 부도칸에 가준다면 난 죽어도 좋아
ONS = "countries/Ongaku Shoujo.txt" #음악소녀
EXT = "countries/Extream Hearts.txt" #Extreme Hearts
PTD = "countries/Project Tokyo Dolls.txt" #프로젝트 도쿄 돌즈
RST = "countries/Re Stage.txt" #Re:stage!
SEL = "countries/SELECTION PROJECT.txt" #SELECTION PROJECT
PTK = "countries/Paripi Koumei.txt" #파티피플 공명
LOC = "countries/Love Rice.txt" #러브 쌀
LOS = "countries/Lemon Squash Score.txt" #레몬 스쿼시 스코어
HDA = "countries/HANDEAD ANTHEM.txt" #HANDEAD ANTHEM
STI = "countries/STATION IDOL LATCH.txt" #STATION IDOL LATCH
HND = "countries/Hana Doll.txt" #하나돌
MKR = "countries/Magic Kyun Renaissance.txt" #매직 큥 르네상스
DEV = "countries/Dear Vocalist.txt" #디어 보컬리스트
URA = "countries/URAMITE.txt" #URAMITE
VAM = "countries/VS AMBIVALENZ.txt" #VS AMBIVALENZ
REA = "countries/Readyyy.txt" #*Readyyy

#NOTE: Useful to add a basic default loc entry for each tag in 00_countries.txt so that hovering over a tag will show the tag's name in loc (ie. PAP: "Papal States")
